
NO ./Makefile
SO ./Makefile
WE ./Makefile
EA ./Makefile
F 20,100,0
C 46,120,12

111111111111111111111111111111111
10000000001100000000000011111111
10110000011100000000000011111111
10010000000000000000000011111111
111111111011000001110000000000001
100000000011000001110111111111111
111101111111110111000000100011111
111101111111110111010100100011111
110000001101010011000000100011111
100000000000000011000000100011111
100000000000000011010100100011111
11000001110101011111011110N01111
11110111111010110101111010001111
11111111111111111111111111111111
