NO ./assets/north.xpm
SO ./assets/south.xpm
WE ./assets/west.xpm    
EA ./assets/east.xpm

F 100,  97,                 97
 
C 255,250,244



111111111111111111111111111111111
1       1000000000110000000000001
1       1011000001100111111111001
1       1001000000001         101
1       1111110111111         101
1       1000000000111         101
1       1011000001111         101
1       1001000000010111111111001
111111111011000000000000000000001
100000000010000001111111111111111
100000000010000001
100000000010000001
100000000110000001
100000001010000001111111111111111
100000010000000000000000000000001
1000010000111111110000000000S0001
10000000001       100000010000001
10000000001       100000000000001
11111111111       111111111111111
   
     



   
         